A person is on a baseball team.	Eine Person spielt in einem Team Basketball.	2.4
Our current vehicles will be in museums when everyone has their own aircraft.	Das Auto muss etwas in Stand gesetzt werden	0.2
A woman supervisor is instructing the male workers.	Eine Frau arbeitet als Krankenpflegerin.	1
A bike is next to a couple women.	Ein Kind neben einem Fahrrad.	2
The group is eating while taking in a breathtaking view.	Eine Gruppe sieht einen ungewöhnlichen Baum an.	2.2
The boy is raising his hand.	Der Mann hebt seine Hand.	3.4
A man with a gray beard is being shaved in front of a lecture hall	Ein Mann mit Bart sitzt im Gras.	0.8
The sky has very little to no clouds.	Diese Frau möchte vielleicht Felsklettern, oder sie schaut einfach nur die Wolken an.	0.4
The young boy jumps barefoot outside in the front yard.	Der Teenager fuhr auf dem Rad um die Menschen im Innenhof.	0.4
There are dogs in the forest.	Die Hunde sind alleine im Wald.	4
Some cyclists stop near a sign.	Zwei Männer unterbrechen ihr Gespräch draußen, nahe einem Schild.	3.4
These cooks in the white are busy in the kitchen making dinner for their customers.	Die Frauen bereiten das Abendessen in der Küche vor.	3
A young person  deep in thought.	Ein junger Mann in Gedanken versunken.	4.6
A man is carrying a canoe with a dog.	Ein Hund trägt einen Mann in einem Kanu.	1.8
A man is performing labor.	Ein Mann tritt heute auf.	2.8
Two men wearing traditional clothing is standing outside.	Drei Frauen, die schwarze Westen und graue T-Shirts tragen, reden vor dem Gebäude.	2
a woman watches a rap group live	Das Publikum beobachtet das tanzende Mädchen.	2.2
A girl dancing on a sandy beach.	Ein Mädchen ist auf einem Sandstrand.	3.6
a man wearing a gray hat fishing out of a fishing boat.	Ein Mann mit einem Strohhut und Fischerweste in einem Fluss. 	2.6
A little girl in an orange striped outfit is airborne whilst bouncing on a bed.	Ein Hund mit rotem Shirt jagt ein Eichhörnchen durch das Glass.	0.2
A person is watching people ski down the hill.	Die Frau springt eine weite Distanz während Leute zuschauen.	1.4
The yard has a dog.	Der Hund rennt hinter dem anderen Hund her.	1.6
The woman is drinking lemonade and watching T.V.	Ein sitzender Mann trinkt Kaffee.	0.4
Three women cook.	Zwei Frauen kochen.	3.2
The woman is kneeling next to a cat.	Ein Mädchen steht neben einem Mann.	0.2
The young adult are cold	Asiatische Kinder spielen mit dem Hund.	0.2
Three guys playing a pro game of basketball.	Zwei Kerle spielen Baseball.	2.4
A sad man is jumping over a small stream to meet his companion on the other side.	Ein Mann springt über den Fluss um seinen Freund auf der anderen Seite zu treffen.	3.8
The boys are earning their next belt in karate.	Fünf Mädchen und ein Junge in Schwimmanzügen springen in den Pool.	0.2
A woman is digging in the sand.	Ein Mann ist unter Sand begraben.	1.4
A woman drives a golf cart.	Ein Mann fährt einen Wagen	1.8
A woman is bungee jumping.	Ein Mädchen spring Bungee.	4.2
A clown performs for brother and sister as the rest of the party watches.	Ein blondes Kind spielt vor dem Haus Trompete, während sein jüngerer Bruder zuschaut.	1.2
A person filming the outdoors.	Draußen ist ein Pärchen.	1.6
A human riding a skateboard.	Ein Kind fährt Skateboard.	3.8
A woman in a plaid outfit is looking through a bag of produce.	Dies ist ein Bild von einer Frau im Blumenkleid, die etwas in einem Eimer schleppt.	1
Four girls happily walk down a sidewalk.	Drei junge Mädchen gehen auf dem Fußgängerweg.	3.4
The tennis player hit the ball into outer space and broke the death star.	Eine Tennisspielerin springt in die Luft um den Ball zu treffen.	1.2
A boy climbs a forest hill.	Ein Junge klettert den Hügel hoch.	4
a group of navy seals are singing	Soldaten spielen in einem Blechbläserquintett.	2.4
Blond boy jumping onto deck.	Ein Junge spring auf eine nasse, aufblasbare Rutsche.	2
A man uses a chainsaw to sculpt a phallic ice sculpture.	Ein Mann nutzt eine Kettensäge zum Schnitzen einer Holzfigur.	2.6
A group of male construction workers repair railroad tracks on a cloudy day	Eine Gruppe Arbeiter arbeiten an den Eisenbahnschienen.	3.8
A man playing the violin in the rain.	Ein Mann spielt Gitarre im Regen.	3.2
The people are leaving the airplane.	Die Menschen betreten das Flugzeug.	2.2
The dogs are chasing a cat.	Die Hunde jagen eine schwarze Katze.	4.4
The girl has something on her head.	Eine Frau hat irgendetwas dabei.	2.6
the tan dog is playing with the red dog out in the snow	Ein gelber Hund spielt im Schnee.	2.6
People making a structure out of cards.	Zwei Leute sind zusammen und nutzen ein Kleidungsstück anders als gedacht.	0.2
a girl with vases in the background inside her house	Das Mädchen steht während das andere, brillentragende Mädchen an ihrer Handmalerei arbeitet.	0.2
There are four people outside.	Fünf Personen stehen draußen.	3
A person sitting in an office takes a picture.	Eine Frau sitzt im Büro.	3.2
Girls are holding hands in blue clothes	Die jungen Leute tragen Jeans mit roten und grünen Shirts.	1.8
People rock jumping into water while people fish in the background.	Zwei Personen beobachten das Wasser.	2.2
A man is demonstrating how to work with clay while at least two people observe.	Mindestens eine der drei Frauen spricht mit den anderen.	0.6
A dog has a sweater on.	Ein Man mit Sakko sitzt auf einem roten Sofa mit einer Katze.	0.6
A blonde woman looks for medical supplies for work in a suitcase.	Die blonde Frau sucht nach Medizin im Koffer.	5
A boy is at school taking a test.	Der Junge schreibt eine Prüfung in der Schule.	5
An old man wearing a hat stands outside a shop door.	Ein Mann mit einem übergroßen Shirt sitzt im Laden.	2.2
Sculptor applying concrete to large statue of human figure standing with no head.	Ein Person steht vor einem Gebäude und hält Sperrholz hoch.	0.2
A boy with dark hair is in water and is looking up.	Der Mann hat kurze Haare.	0.6
A pole is behind a person that is playing peekaboo with a child.	Das ist ein Kind mit einem Ball.	0.2
A woman is about to paint.	Der Junge macht ein Foto.	1
The carriage is drawn by a horse.	Ein Mann auf einem Fahrrad neben einem Gebäude.	0.4
a man working at the steel mill	Ein Mann arbeitet in einer Gießerei.	3.4
The young woman is flirting with the young boy.	Das Mädchen ist jung und heiter.	1.4
A woman looks at a duck as she walks behind it.	Eine Frau geht mit ihrem Hund spazieren.	1
the men are about to score in a water polo tournament	Die zwei Männer stehen vor einem Wettkampf.	2
Man sitting on a bench drink from a mug surrounded by rugs.	Ein Mann sitzt auf einem von zwei roten Bänken und starrt in einen Kiosk.	2.2
A man eats popcorn while watching cartoons late one night.	Ein Mann und ein Mädchen schauen zuhause Cartoons.	2.8
Three men sit on a bench.	Zwei Männer sitzen auf einer Bank.	3.2
The road is long.	Da ist nichts neben der Straße.	0.8
A small blond boy slides head first down a blue playground slide toward another blond youth.	Ein kleiner Junge mit hochstehenden Haaren rutscht auf einer blauen Rutsche.	2
The four women are practicing for a upcoming match.	Die Frauen haben einen Auftritt.	1.2
a young man wearing a white t-shirt and green and black shorts standing on a stump.	A Mann mit weißem Hemd und kurzer, rot-schwarzer Hose rennt auf dem Gehweg. 	1.8
man on steps	Ein Mann sitzt auf einer Stufe.	4
A dog under the stairs	Ein Hund ruht sich auf Stühlen aus.	2.2
There is a young girl.	Da ist ein kleiner Junge mit einer Frau.	1
Two women give a demonstration at a Renaissance Fair.	Zwei Personen demonstrieren bei einer Renaissancemesse.	4.2
A woman paints a picture of a large building which can be seen in the background.	Ein Person malt ein Bild von einem großen Gebäude, das man im Hintergrund sehen kann.	4.2
Some guy sitting on a couch watching television.	Ein Kerl sitzt auf dem Sofa und schaut TV.	5
A woman is posing for a Christmas card.	Ein Mädchen macht ein Bild.	1.2
Two kids are playing a game of Foosball.	The Kinder spielen zusammen.	3.4
The man is in a deserted field.	Ein Mann ist draußen im Feld.	4
A little boy is drinking from a juice packet.	Ein Junge trinkt aus einem Getränkekarton.	4.8
A man has his skis ready for the field to get iced out	Ein Mann auf einem Boot ist bereit ein Netz einzuziehen, um seinen Fang zu begutachten.	0.4
The biker is doing dangerous stunts.	Ein Motorradfahrer macht Stunts.	4.4
A musician is smearing jam on his white guitar at a concert.	Eine Posaunistin spielt ihr Instrument in einer Band für eine Parade.	0.4
A man is working on his farm.	Ein alter Mann arbeitet auf der Farm während eine Kuh ihn tritt.	2.8
A pair of young boys in t-shirts are hiding in the woods with one looking aghast.	Zwei kleine, lächelnde Mädchen spielen im Springbrunnen mit anderen Personen.	0
A group of people playing soccer on a soccer field in front of a crowd.	Männer spielen Fußball in einem vollen Stadium.	3
A man is enjoying watching three asian children dance.	Ein Mann beobachtet drei asiatische Kinder beim Tanzen.	4.6
A girl is talking to her dad on a cellphone.	Ein Mädchen telefoniert.	4.4
One person wields an umbrella.	Eine Person hält einen Regenschirm.	4.4
A woman walking down the side of a highway.	Ein Mann steht mit einem Bein auf einer Brücke.	0.4
A group of teenagers jumping and having a good time.	Eine Gruppe Kinder haben eine glückliche Zeit.	3.6
A man calling for a taxi at the airport on a sunny day.	Ein Mann ist draußen an einem Juli-Tag.	1.4
A man is playing his guitar at Joe's Cafe.	Der Mann spielt das Schlagzeug für seine Mutter.	1.2
A young boy has a red fishing pole.	Ein kleiner Junge steht auf der Brücke mit seiner Angel.	3
A player bounces a ball.	Ein Spieler fängt den Ball.	1.6
Someone is on a blanket.	Die Person macht eine Decke.	1.4
Men competing in a contest.	Zwei Frauen stehen in einem Wettkampf.	2.4
The puppy is outdoor.	Ein Mann mit bedruckter Badehose steht in einer Yoga-Pose auf dem Strand.	0
The man has a orange shirt.	Die Frau trägt eine orangene Bluse.	3.4
The two kids look at the products sold inside the subway shop.	Die Kinder stehlen aus dem Laden.	0.8
The baby boy wants his mother.	Ein Baby freut sich, seine Mutter zu sehen.	2.8
A young girl in a pink jacket is playing a board game.	Ein Junge mit Jacke spielt.	1.6
A smiling Caucasian male wearing a blue and black striped shirt it about to take a photograph.	Ein Mann mit weißem Hemd und schwarzer Hose lächelt.	1.6
A person is scaling a rock wall.	Eine Person und ein Pferd sind über einem Zaun.	0.2
A boy is very close to a girl.	Ein Mädchen steht dicht bei einem Jungen, dessen Gesicht man nicht sieht.	3.2
Two men are playing a game of Scrabble together.	Zwei Frauen spielen ein Spiel.	2.2
Six children are cleaning a room.	Zwei Jungs rechen Laub auf einem Parkplatz.	1.6
The girl is very skilled and practices a lot.	Der Mann ist sehr talentiert.	2
Many guards are standing in front of the starting line of a race.	Zwei Männer im Business-Outfit stehen am Rand der Straße.	0.4
There is a cook preparing food.	Ein Koch bereitet Essen zu.	5
Two men are helping a boy.	Zwei Männer und ein junges Kind.	3.6
A man at a farmers market.	Ein Mann ist auf einem Bauernmarkt.	4.8
four people walk toward a tower	Zwei Männer gehen auf ein domartiges Gebäude.	2
A little girl and boy are reading books.	Ein älteres Kind spielt mit einer Puppe, während es aus dem Fenster schaut.	0.2
The child would like to swim.	Die Kinder wollen schwimmen.	3.8
Two skiing people are doing cross country skiing.	Leute beim Skilanglauf.	3.6
A dog taking a poop in the street.	Ein Mann an einer Straßenecke macht Luftballontiere für Kinder.	0.4
Men are fighting after a basketball game.	Die Männer spielen eine Runde Basketball.	2.2
A kid is talking in class.	Ein Mädchen geht in den Unterricht.	1.8
The women are trying to sell something to the individual.	Die Männer versuchen Geld zu verdienen.	1.2
People are waiting for the fireworks to start.	Drei Personen warten, dass der Regen aufhört.	1.2
A dog prepares to herd three sheep with horns.	Ein Hund und ein Schaf laufen zusammen.	2.2
People are sitting around dimly lit tables while smiling and laughing.	Leute sitzen auf Bänken.	2
A dog is chasing cows.	Ein weißer Hund jagt Kühe.	4
One football player tries to tackle a player on the opposing team.	Ein Football-Spieler probiert einen Tackle.	4.6
Three men are drying to pull a Subaru out of a ditch along a mountain road.	Zwei Männer warten am Rand einer Schotterstraße auf eine Mitfahrgelegenheit.	1.4
A woman doesn't have her arms up because she's paralyzed from the neck down	Eine Frau sitzt auf den Stufen, weil sie gestürzt ist und ihren Knöchel verletzt hat.	0.8
People gathered in a room.	Leute versammelt in einem Raum.	5
The woman in overalls paints a picture for her wall.	Eine Frau malt die Wand weiß an.	2.6
Adding aspirin to the water could kill the plant.	Männer versuchen Öl aus dem Wasser zu entfernen.	0
Five kids are standing in front of a tent.	Personen sitzen vor einem Garten.	0.6
Female in a maroon shirt engaged in conversation with another female in a tan blazer.	Ein Mädchen mit blauem Outfit und ein Mädchen mit lila Outfit lächeln.	1.2
Baseball players playing a game at the park.	Ein Basketball-Spieler spielt im Home-Coming-Spiel.	1.6
They are preparing for a performance at school.	Zwei Ärzte in Grün schauen auf etwas.	0
The woman is wearing yellow.	Die Frau trägt rot.	2.8
Some smiling children are standing in front of an ocean sunset.	Leute laufen im Dunkeln.	0.6
A man is doing a stunt on his bicycle.	Ein Mann macht einen Wheelie auf seinem Motorrad.	3.2
Ten people riding ATVs.	Vier Personen fahren Fahrrad.	1.6
Two fishermen try to untangle their large fishing net on the side of the road on a cloudy day.	Mehrere Männer ziehen ein Fischernetz an den Strand.	3
A yellow vested person is doing road work.	Eine Person ist gekonnt auf dem Skateboard.	0.2
The woman had brown hair.	Die Frau hat graue Haare.	2.4
Black and white image of a wave crashing in the ocean.	Ein kleiner, schwarzer Hund im Meer mit ein paar Felsen im Hintergrund.	0.6
A lady and her daughter look through a microscope.	Ein Mädchen und eine Frau schauen beide durchs Mirkoskop.	4.6
Two workers are sitting next to pipes eating lunch	The Bauarbeiter machen Pause und essen Mittag.	3.8
A boy does a skateboard trick on the stairs downtown.	Ein Junge läuft auf dem Gehweg.	0.6
A group of people living in the desert	Eine Gruppe von Personen in der Mitte einer Wüste.	4
Two kids are swimming.	Sechs Kinder gehen schwimmen.	2.8
Three humans are walking a dog.	Drei Personen führen den Hund spazieren.	4.8
There are people out on the street.	Leute sind draußen auf der Straße.	5
people getting their dirty clothes cleaned	Leute bekommen ihre Kleidung gereinigt.	5
Two women are lost and calling for help.	Zwei asiatische Männer mit ihren Kindern sammeln Material für ihr Geschäft. 	0.2
A man is throwing a penny into a fountain.	Ein kleiner Jung wirft einen Mann ins Wasser.	0.6
The children are holding musical instruments.	Eine Gruppe Kinder spielt Musikinstrumente und singen.	3.4
Two girls are playing Doctor inside their house.	Die zwei Mädchen gehen zusammen mit ihrem Vater.	0.8
A crowd of men wearing paper numbers on their shirts run in a race.	Mehrere Männer gehen über den Rasen und haben Nummern vorne auf ihrem Shirt.	3.6
A group of people are wearing police uniforms conducting an arrest.	Eine Gruppe Polizisten tragen Schutzkleidung.	2.8
The fruits should be eaten with lemon juice in order to prevent oxidation in your stomach.	Drei Hunde knurren sich an.	0
A doctor prescribes medicine to a patient.	Ein Arzt verschreibt Medizin.	4.4
A woman is in the bathroom.	Die Frau ist im Badezimmer.	4.6
Spectators taking pictures of a rally car.	Eine Gruppe schaut Rennwagen auf der Rennstrecke zu.	2.8
The man and woman are resting on a couch.	Ein Mann und eine Frau schlafen auf dem Sofa.	4
the man is planning to shoot a wedding	Die Frau geht zu einer Hochzeit.	1.4
The boy in the green jersey plays goalie on the soccer team.	Das Team in Blau spielt gegen das Team in Weiß.	1
The child's bike got wet.	Sie stellt das Fahrrad weg.	1.2
A soldier walks a dog.	Ein Mann geht mit einem Hund spazieren.	3.2
A shirtless woman is operating a lawn mower.	Das Mädchen mäht den Rasen.	3
People are near water	Personen befinden sich in der Nähe von Wasser.	5
The two officers are driving	Zwei Polizisten sitzen auf Pferden.	2.2
Friends walk into a building	Ein Mann geht auf dem Gehweg zu einem Geschäft.	0.4
The lady looks sad because no one is buying her wares.	Die Frau verkauft Sachen.	2
The rollerblades are moving.	Zwei Fahrzeuge bewegen sich auf die Kamera zu.	0.8
There is a older man near a window.	Ein Junge ist nahe einer Treppe.	0.4
A guy and a girl are rock climbing with backpacks on.	Zwei Jungs reiten auf einem Spielzeug und ein blondes Mädchen läuft an ihnen vorbei.	0
In Abu Dhabi the Golden Market is one of the premier public outdoor shopping areas.	Ein voller Platz in einem asiatischen Land.	1.6
A pregnant woman is in labor	Eine Frau mit einem Kind.	1.6
A flock of birds hovered over the sandy beach.	Vögel fliegen zu einer Bank.	3.8
people walk home	Wartende Leute.	1.6
The religious people are enjoying the outdoors.	Eine Gruppe genießt es draußen zu sein.	3.6
A girl in water without goggles or a swimming cap.	Ein Mädchen im Wasser, mit Brille und Schwimmmütze.	3
A man is performing a stunt outdoors.	Ein junger Mann am Strand führt Tricks mit dem Skateboard vor.	2.8
A man is laughing with a woman	Ein Mann und eine Frau am lachen.	4.8
He is about to run into the boat	Der Mann holt das Boot aus dem Wasser um es zu reinigen.	1.2
2 Cows are in a field.	Zwei Schafe auf einer Wiese.	2.4
A wet child enjoys the summer.	Eine Frau genießt das Sommerwetter.	1.8
There was girl stranded on the roof.	Das Pärchen war auf dem Bett.	0.2
There are four snowboarders going off a jump and that are in the air.	Zwei Rennfahrer bewegen sich auf eine Kurve zu.	1
The girl has a driver's license	Ein Mann mit einem Führerschein.	2.6
People on motorcycles wearing racing gear ride around a racetrack	Motorradfahrer fahren auf einer Rennstrecke.	3.8
A man is standing on the ground with a paintbrush	Ein Mann mit einer Krücke liegt auf dem Boden.	1.2
The kids are at the theater watching a movie.	Heute ist Fototag für die Jungs.	0.2
Two women walk down the sidewalk to the store.	Zwei Frauen gehen am Nachmittag auf dem Gehweg. 	3.8
A man has his son on his back	Ein Mann verbringt Zeit mit seinem Sohn.	2.4
A group of dark-skinned people are walking past barbed wire.	Zwei Frauen tratschen am Zaun.	0.4
Zombies parading around eating brains.	Die Zombies essen Fleisch.	3.4
A group of people are sitting at at a beach on towels watching the Blue Angels.	Eine Gruppe sitzt am Strand und beobachten die Blue Angels.	4.2
A basketball player makes the 5th rebound of the night,	Ein Tennisspieler während einer Partie.	1.4
Three people are meeting for coffee.	Zwei Personen machen Kaffee.	2.4
A young girl with dirt on her face and a red child's bike is in the background.	Die alte Frau in kurzen Hosen mit weißem T-Shirt steht auf einem Weg und beobachtet Kinder beim Spielen.	0.8
A helicopter is getting ready to take off.	Das Flugzeug wird für den Start vorbereitet.	2.8
A line of scooters are parking in the middle of a street.	Motorräder parken in einer Reihe in der Mitte der Straße.	4.4
A man holding a cat.	Ein Mann hält einen Hund.	3
A man doing a jumping bike trick surrounded by trees.	Ein Junge fährt draußen auf einem grünen BMX Rad über ein paar Stufen.	3
Three guys in speedos have their feet up on the railing of a boat getting a tan.	Ein paar Männer an Deck werfen einen Mann ins Wasser.	1.6
A group wading across a witch	Eine Gruppe watet durch einen Graben	2.8
A woman jumps and poses for the camera.	Eine Frau posiert für die Kamera.	4
A man is on a rooftop	Ein Mann hält ein Mikrofon in den Raum.	0.8
There are two men near a wall.	Drei Frauen sitzen nahe einer Mauer.	2
The cats are running through the grass.	Einige Hunde rennen durch den Park.	2
The two boys are playing kick ball back and forth to each other.	Die Spieler treten sich gegenseitig während sie versuchen den Ball zu erwischen.	3
Two girls are running.	Drei Jungs rennen.	2.2
The two men are wearing jeans.	Die zwei Männer tragen Hosen.	4.4
A little girl in a white blouse and blue pants frolics on the grass.	Die Frau mit grüner Bluse und weißer Hose spielt Golf.	1.8
The man without a shirt is jumping.	Der springende Mann trägt kein Oberteil.	4.6
The woman is holding the hands of the man.	Die Frau schaut in die Augen des Mannes.	2.4
A man walks his dog on the beach.	Ein Mann mit seinem Hund am Strand.	4.4
The child is the woman's kid.	Das ist ein Junge und ein Mädchen.	0.8
A soccer player is kicking the ball.	Der Fußballspieler schoss den Ball in die Höhe.	3.8
Two boys in black swimming trunks are holding another boy by his arms and legs on a beach.	Der Mann mit weißem Oberteil wirft den kleinen Jungen ins Wasser während vier andere Jungs darum stehen.	1.4
The player shoots the winning points.	Der Basketball-Spieler steht davor Punkte für sein Mannschaft  zu erzielen.	2.8
A man in a white shirt and hat playing a guitar.	Ein Mann mit grünem Shirt und schwarzem Hut spielt Gitarre auf der Bühne.	2.8
A black hooded man is using a large magnifying glass to look at a booklet.	Ein Frau mit weißem Kapuzenpulli nutzt eine Lupe um sich ein Prospekt anzuschauen. 	2.8
the people are running a marathon	Leute laufen einen Marathon.	5
A motorcross driver going by during a race	Ein Rennfahrer fuhr das Rennen seines Lebens.	3
A group of people are nervous about crossing the water.	Eine Gruppe von Personen ist auf dem Wasser.	2.2
A group of kids are having a jumping contest.	Eine Gruppe Kinder haben eine Übernachtungsparty.	1.2
The gate is blue.	Das Tor ist gelb.	1.6
The person is wearing a fedora.	Ein Mann trägt eine Uniform.	1.6
A woman and a man embrace while watching a horror movie.	Eine Frau und ein Mann schauen einen Film.	2.8
A man in a blue dress shirt.	Ein Mann mit weißem Hemd und blauer Hose redet mit einer Frau mit rosa Oberteil.	1.8
A couple is playing the game of Life.	Die Familie spielt zusammen ein Brettspiel.	2.6
The head of a child with dark glasses is in focus.	Das ist eine Frau mit vollem Haar.	0.2
A dog walks along a beach with breaking waves.	Ein Junge mit einem Ruder geht aus der Brandung raus hin zum Strand. 	1
A pair of men walk along the beach.	Zwei Männer stehen in der Brandung am Strand.	2.6
Blond woman in a tunnel.	Das küssende Pärchen steht nahe einer blonden Frau.	1.6
A maintenance guy is repairing a net on a tennis court.	Ein Mann entfernt das Tennisnetz.	2.4
A kid sits on a soccer ball outside.	Ein Kind sitzt auf dem Fußball nahe dem Park.	4.2
The raven droned as is hopped along the grass.	Der dünne Hund mit dem langen Schwanz läuft durch das Feld.	0.2
A man in a brown coat rubs his nose.	Der glatzköpfige Mann mit rotem Bart hält seine Hand nahe dem Mund.	2.2
The dog is chasing the geese.	Ein Hund jagt einen anderen.	1.6
Small child playing with letter P	Zwei junge Mädchen sitzen vor einem Bücherregal, ein Mädchen liest ein Buch.	0.8
A brown dog is jumping.	Ein brauner Hund ist am springen.	5
the man is catching a ball	Ein Mann tritt einen Ball.	3
Two men are sitting in the room.	Zwei Männer stehen in einem Raum.	3
A group of teenagers in red shirts are smiling.	Eine Gruppe von Leuten trägt orangene Oberteile.	1.2
The woman is waiting for her date.	Die Frau ist auf dem Weg zu ihrem Date.	3.2
